1111111111111
100100C0000C1
1000011110011
1P00111E00001
1111111111111
