1111111111111
1110000000C11
1000011111001
1P0111C0E0001
1111111111111
