1111111111111
1110000000C11
1000011111001
1P011100EC001
1111111111111
