1111111111111
100100C0000C1
1000011110011
1P0C111E00011
1111111111111
