1111111111111111111111
1010C000001C0010001001
1010011101C010001000C1
1010010101P101111111C1
1010010100100010001001
1EC0010010001000100011
1111111111111111111111
