1111111111111
1111000000C11
1001011111001
1P01110CE0001
1111111111111
