1111111111111
1110000000C11
1000011111001
1P01110CE0001
1111111111111
