1-VALID
1111111111111
1111000000C11
1000011111001
1P011100E0001
1111111111111

2-VALID
1111111111111111111111111111111111
1C0000000000000C00000C000000000001
1010010100100000101001000000010101
1010010010101010001001000000010101
1P0000000C00C0000000000000000000E1
1111111111111111111111111111111111

3-ERROR
1111111111111
1111000000C11
1001011111001
1P01110CE0001
1111111111111

4-ERROR
1111111111111
1111000000C11
1001011111001
1P0111C0E0001
1111111111111

5-ERROR
1111111111111
1111000000C11
1001011111001
1P011100EC001
1111111111111

6-ERROR
1111111111111
1111000000C11
1001011111001
1P0111C1E0001
1111111111111

7-ERROR
1111111111111
1111000000C11
1001011111001
1P0111E1C0001
1111111111111

8-ERROR
1111111111111
1110000000C11
1001011111001
1P01110CE0001
1111111111111

9-ERROR
1111111111111
1110000000C11
1000011111001
1P01110CE0001
1111111111111

10-ERROR
1111111111111
1110000000C11
1000011111001
1P0111C0E0001
1111111111111

11-ERROR
1111111111111
1110000000C11
1000011111001
1P0111CCE0001
1111111111111

12-VALID
1111111111111
1110000000C11
1000011111001
1P011100EC001
1111111111111

13- VALID
1111111111111111111111
1010C000001C0010001001
1010011101C010001000C1
1010010101P101111111C1
1010010100100010001001
1EC0010010001000100011
1111111111111111111111
